{
  "tileSize": 32,
  "width": 16,
  "height": 16,
  "tiles": {
    "0": { "name": "grass", "color": "#3a5a40", "solid": false },
    "1": { "name": "water", "color": "#274c77", "solid": true },
    "2": { "name": "sand",  "color": "#c2a878", "solid": false },
    "3": { "name": "stone", "color": "#6c757d", "solid": true },
    "4": { "name": "path",  "color": "#8a7a5c", "solid": false }
  },
  "data": [
    [3,3,3,3,3,3,3,3,3,3,3,3,3,3,3,3],
    [3,0,0,0,0,0,0,0,0,0,0,0,0,0,0,3],
    [3,0,0,0,4,4,4,4,4,4,0,0,0,0,0,3],
    [3,0,0,0,4,0,0,0,0,4,0,0,1,1,0,3],
    [3,0,2,2,4,0,0,0,0,4,0,1,1,1,1,3],
    [3,0,2,2,4,0,0,0,0,4,0,1,1,1,1,3],
    [3,0,0,0,4,4,4,4,4,4,0,0,1,1,0,3],
    [3,0,0,0,0,0,0,0,0,0,0,0,0,0,0,3],
    [3,0,0,0,0,0,0,0,0,0,0,0,0,0,0,3],
    [3,0,0,3,3,3,0,0,0,0,0,2,2,2,0,3],
    [3,0,0,3,0,3,0,0,0,0,0,2,2,2,0,3],
    [3,0,0,3,3,3,0,0,0,0,0,2,2,2,0,3],
    [3,0,0,0,0,0,0,0,4,4,4,4,4,0,0,3],
    [3,0,0,0,0,0,0,0,4,0,0,0,0,0,0,3],
    [3,0,0,0,0,0,0,0,4,0,0,0,0,0,0,3],
    [3,3,3,3,3,3,3,3,3,3,3,3,3,3,3,3]
  ]
}
